111111111111111111111111111
121000000010001000001000001
101011111010101010101011101
100010000010101010101011101
111110111110101010101011101
100010000010101010000011101
101011111010101111111111101
101010001000100000000000001
101010111111101111111111111
101000000000100010000001111
101111111110111010111100001
100010000010000010000111101
111010111111111111111111101
100010000000000000100000001
101111111111111010111110101
100000000000001010100000101
111111111111101010101111101
100000000000000010001000001
101111111111111111111111101
100000000000000001111111101
111111111111111101111111301
111111111111111111111111111
