1111111111111111111111111111
1210000001000000000000000001
1010111100011111111111111101
1010100001010000000000000001
1010111101010111111111111111
1010100001010100000000000001
1010101111011101111111111101
1010101000000001000000000001
1000000011111111111111111101
1111111110000101010000000101
1010000000111101011111110101
1010111011100101010000000101
1000100000001100010111110101
1111101111111001010000010101
1000001000000011011011110101
1011111011111110000010000001
1000000010000000111111111111
1111111011111111100000000101
1000000010000000001111111101
1011111110111111011000100001
1000000000100000000010001131
1111111111111111111111111111